A chilling wind blows in the late afternoon. You catch sight of the house that you have to evaluate. The house scares you and you try to gain some confidence: "Ok Carlos, it is just another house to evaluate. You've done this on hundreds houses before. Just get in, see all the rooms, and get out. Very simple.". Still, the fact that it is the only house in the street gives signs that something is wrong.

Coming Home
An Interactive Fiction by Clóvis, Ramiro and Pedro
Release 1 / Serial number 190815 / Inform 7 build 6M62 (I6/v6.33 lib 6/12N) SD

Porch
The entrance shows the house's condition. Old and abandoned.

You can see Main door, Main key, Wooden chair, Old box (in which are candle and string), bucket (empty) and a bear trap (in which is dog) here.

>Test me with “release dog / take key / open main door / look photo / north
I only understood you as far as wanting to test that.

>release dog
Go away dog!

You saved the dog from the trap. He is very thankful.

>take key
(Main key)
A chill runs up your spine
Taken.

>open main door
It seems to be locked.

>unlock main door
(with Main key)
You unlock Main door.

* * *

>dog
That's not a verb I recognise.

>look to dog
You can't see any such thing.

>talk to dog
That's not a verb I recognise.

* * *

>enter main door
(first opening Main door)
It seems to be locked.

>unlock main door
What do you want to unlock Main door with?

>main key
(first taking Main key)
A chill runs up your spine
You unlock Main door.

>enter door
(first opening Main door)

Hall
You can see Gray door, Main door, Red door and Wooden Table (on which is family photograph) here.

The inside smells as bad news...

>enter stair
You can't see any such thing.

* * *

>enter stairs
Pode ir, senhor.

Hall
The room is dark and difficult to see without light.

The stairs are... weird?

You can also see Gray door, Main door, Red door and Wooden Table (on which is family photograph) here.

The inside smells as bad news...

* * *

>examine bear trap
In the bear trap is dog.

>free dog
I didn't understand that number.

>release dog
Go away dog!

You saved the dog from the trap. He is very thankful.

>take main key
A chill runs up your spine
Taken.

>take candle
Taken.

>enter main door
(first opening Main door)
It seems to be locked.

>open main door
It seems to be locked.

>unlokc main door
I didn't understand that number.

>unlock main door
What do you want to unlock Main door with?

>key
(Main key)
You unlock Main door.

>enter main door
(first opening Main door)

Hall
The room is dark and difficult to see without light.

You can see Gray door, Main door, Red door, Stairs and Wooden Table (on which is family photograph) here.

The inside smells as bad news...

>examine stair
You can't see any such thing.

>examine stairs
The stairs are... weird?

>climb stair
You can't see any such thing.

>climb stairs
When you put your foot on the eighth step of the stairs, the whole stair transform itself in a ramp. You roll down the ramp and returns to the hall. You are hurt but fortunately you didn't break anything. You hear a strange laugh coming from upstairs.

>light candle
This dangerous act would achieve little.

>n
(first opening Red door)

Living Room
This room is oddly empty, like a hurricane has passed by removing all the furniture. Only 4 doors can be seen.

You can see White door, Red door, Brown door and Yellow door here.

>n
(first opening Yellow door)

Dining Room
The dining room looks like to be more conserved than the other rooms. The forniture is fancy, but very strange.

You can see Yellow door, Green door, Large Wooden Table (on which is fresh apple), Old Chair and Shelf (on which is strange photograph) here.

>examine strange photograph
You see nothing special about strange photograph.

There is a old woman writing or drawing something behind a painting.

>take strange photograph
I should take a closer look.

>look table
On Large Wooden Table is fresh apple.

>look apple
A normal, red and fresh apple.

>take apple
Suddenly, the apple begins to rot in your hands, the radio turn on and start to play strange sounds. You can hear strange heart beats coming from the eletronic device.

>w
(first opening Green door)

Kitchen
It seems to be a normal kitchen, but not used for a long time. There are rotten food in the cabinet and a few dead rats on the floor. The smell is intolerable. You feel seasick only by staying in this room.

You can see Green door, Orange door, Furnace (on which is old pressure cooker), Simple Table (on which are an Orange key and dirty napkin) and Cabinet (empty) here.

>s
(first opening Orange door)
It seems to be locked.

>examine key
(Main key)
An old and robust key. It seems like it is not used for more than 10 years. Probably opens the Main Door.

>examine orange key
It is pretty clear that it opens the orange door.

>take orange key
Taken.

>s
(first opening Orange door)
It seems to be locked.

>unlock s
What do you want to unlock south with?

>orange key
You must name something more substantial.

>unlock orange door
What do you want to unlock Orange door with?

>orange key
You unlock Orange door.

>s
(first opening Orange door)

I beg your pardon?

>s
You can't go that way.

>enter orange door
Kitchen
It seems to be a normal kitchen, but not used for a long time. There are rotten food in the cabinet and a few dead rats on the floor. The smell is intolerable. You feel seasick only by staying in this room.

You can see Orange door, Green door, Furnace (on which is old pressure cooker), Simple Table (on which is dirty napkin) and Cabinet (empty) here.

* * *

I beg your pardon?

I beg your pardon?

* * *

>s
You can't go that way.

I beg your pardon?

>n
Kitchen
It seems to be a normal kitchen, but not used for a long time. There are rotten food in the cabinet and a few dead rats on the floor. The smell is intolerable. You feel seasick only by staying in this room.

You can see Orange door, Green door, Furnace (on which is old pressure cooker), Simple Table (on which is dirty napkin) and Cabinet (empty) here.

>move to Garage
You already have that.

Now you are in the Garage

>look
Garage
The garage is fully of rotten boxes. A weak light beam comes from a small window. The smell is bad, but is a relief compared to the kitchen.

You can see Orange door, Brown door, deflated ball, wooden planks and a homeless here.

>talk to homeless
1: "Who are you?"
2: "Where are you"
3: "Why are you there?"

>1
1: "Who are you?"

"As I said, my name is Charles. I am a homeless." he replies.
1: "Where are you"
2: "Why are you there?"

>3
No such option is available.

>1
1: "Where are you"

"I am locked in the Garage room." he replies.
1: "Why are you there?"

>1
1: "Why are you there?"

"I was looking for some gods in this abandoned house and I got locked here after falling through the tipper 
Could you help me? I have a god to you!

Could you help me? I have a god to you!
1: "Yes"
2: "No"

>1
1: "Yes"

"Fine, follow my instructions." he replies.
I am at Garage Room, you need to find a way to open its door!

You are alone again, no more conversations.

>look
Garage
The garage is fully of rotten boxes. A weak light beam comes from a small window. The smell is bad, but is a relief compared to the kitchen.

You can see Orange door, Brown door, deflated ball, wooden planks and a homeless here.

>take all
deflated ball: Taken.
wooden planks: Taken.
Gray key: That seems to belong to the homeless.

>examine homeless
The homeless introduced himself to you and his name is Charles.
Maybe he has something to tell you...

>talk to charles
1: "Ok, here I am. You can go away"
2: "Ohh, here you are... You are hurt? Needs more help?"

>1
1: "Ok, here I am. You can go away"

"Thank you so much.
Take this key, I found it in the Hall.
Maybe it opens a door somewhere around there" he replies.
You pick the key from homeless.

I beg your pardon?

>look
Garage
The garage is fully of rotten boxes. A weak light beam comes from a small window. The smell is bad, but is a relief compared to the kitchen.

You can see Orange door, Brown door and Charles here.

>i
You are carrying:
  a Gray key
  wooden planks
  deflated ball
  ruby stone
  an Orange key
  rotten apple
  strange photograph
  candle
  Main key

>n
Kitchen
It seems to be a normal kitchen, but not used for a long time. There are rotten food in the cabinet and a few dead rats on the floor. The smell is intolerable. You feel seasick only by staying in this room.

You can see Orange door, Green door, Furnace (on which is old pressure cooker), Simple Table (on which is dirty napkin) and Cabinet (empty) here.

>e
Dining Room
The dining room looks like to be more conserved than the other rooms. The forniture is fancy, but very strange.

You can see Green door, Yellow door, Large Wooden Table, Old Chair and Shelf here.

>s
Living Room
This room is oddly empty, like a hurricane has passed by removing all the furniture. Only 4 doors can be seen.

You can see Brown door, Yellow door, White door and Red door here.

>s
Hall
The room is dark and difficult to see without light.

You can see Red door, Gray door, Main door, Stairs and Wooden Table (on which is family photograph) here.

>unlokc Gray door
I didn't understand that number.

>unlock Gray dor
I didn't understand that sentence.

>unlock Gray door
What do you want to unlock Gray door with?

>gray key
You unlock Gray door.

>enter gray door
(first opening Gray door)

Lavabo
There was a good reason the door was closed. The toilet is unusable. The smell is as bad as in the kitchen. A mirror hanging on the wall attracts  your attention.

You can see Gray door, Old Mirror, Toilet, dirty towel and Wash Basin here.

>examine toilet
Impossible to use.

>examine dirty towel
All dirty of blood.

>take all
dirty towel: Taken.

>examine wash basin
You see nothing special about Wash Basin.

>examine old mirror
The mirror frame is made of gold. Well detailed. When look inside the mirror you see... another room?

You put the finger inside the mirror. It disappears. You put your hole hand and it also disappears. You don't think twice. You enter with all your body in the mirror. First you start to fell dizzy. Then things become worse. It is like your soul was taken off your body and travelled in an infinite speed. You see thousands of things and nothing at the same time. You cannot know if 5 seconds has passed or 5 days. It is the most painful sensation you have ever experienced. 
Inner Bathroom
The decoration on this room is very similar to the other rooms. The mirror hanging on the wall is identical to the mirror in the lavabo.

You can see Blue door, Marble Wash Basin (on which is Soap), Bathtub, Dirty Mirror and Marble Toilet here.

>examine mirror
Similar to the other mirrors on the house. You can see the Lavabo.

You put the finger inside the mirror. It disappears. You put your hole hand and it also disappears. You don't think twice. You enter with all your body in the mirror. First you start to fell dizzy. Then things become worse. It is like your soul was taken off your body and travelled in an infinite speed. You see thousands of things and nothing at the same time. You cannot know if 5 seconds has passed or 5 days. It is the most painful sensation you have ever experienced. And still, you tried it again.

Lavabo
There was a good reason the door was closed. The toilet is unusable. The smell is as bad as in the kitchen. A mirror hanging on the wall attracts  your attention.

You can see Gray door, Old Mirror, Toilet and Wash Basin here.

>examine mirror
The mirror frame is made of gold. Well detailed. When look inside the mirror you see... another room?

You put the finger inside the mirror. It disappears. You put your hole hand and it also disappears. You don't think twice. You enter with all your body in the mirror. First you start to fell dizzy. Then things become worse. It is like your soul was taken off your body and travelled in an infinite speed. You see thousands of things and nothing at the same time. You cannot know if 5 seconds has passed or 5 days. It is the most painful sensation you have ever experienced. 
Inner Bathroom
The decoration on this room is very similar to the other rooms. The mirror hanging on the wall is identical to the mirror in the lavabo.

You can see Blue door, Marble Wash Basin (on which is Soap), Bathtub, Dirty Mirror and Marble Toilet here.

>examine Bathtub
There is a corpse in it.

>examine marble toilet
You see nothing special about Marble Toilet.

>e
You can't go that way.

>w
Large Bedroom
This bedroom is very large. The windows are covered by wood planks, but a hole on the ceiling allows the light to enter on the room. A beautiful painting is hanging on the wall.

You can see Blue door, Black door, Beautiful Painting, Large Bed and Wardrobe (in which is moldy shirt) here.

>examine large bed
You see nothing special about Large Bed.

>s
(first opening Black door)

Upper Hall
The decoration in this room is creepy. This room has stairs which gives access to the lower floor. And down the stairs, you see the Hall and the Main Door.

You can see Heart-painted door, Purple door, Black door, Stairs, Scratched door and Stone Statue here.

>examine stairs
The stairs are... weird?

>examine stone statue
A scaring statue holding still, like if it is almost moving. You can deduce that it has two ruby eyes. One is in the statue, the other one is missing. Maybe if I find the lost eye, It will be possible to "interact with" the Statue.

>enter black door
Large Bedroom
This bedroom is very large. The windows are covered by wood planks, but a hole on the ceiling allows the light to enter on the room. A beautiful painting is hanging on the wall.

You can see Black door, Blue door, Beautiful Painting, Large Bed and Wardrobe (in which is moldy shirt) here.

>s
Upper Hall
The decoration in this room is creepy. This room has stairs which gives access to the lower floor. And down the stairs, you see the Hall and the Main Door.

You can see Black door, Heart-painted door, Purple door, Stairs, Scratched door and Stone Statue here.

>w
(first opening Scratched door)

Small Bedroom
The stink is the first thing noted in this room. The second is the source of the stink. A corpse is laid down on the bed. The small dimension of this room and the corpse on the bed give you a claustrophobia's sensation.

You can see Scratched door, Small Bed (on which is Little Girl's Corpse) and Small Wardrobe (on which is pink dress) here.

>examine corpse
A young girl is dead. It appears that she was sleeping before die.

>w
You can't go that way.

>s
You can't go that way.

>n
You can't go that way.

>e
Upper Hall
The decoration in this room is creepy. This room has stairs which gives access to the lower floor. And down the stairs, you see the Hall and the Main Door.

You can see Scratched door, Black door, Heart-painted door, Purple door, Stairs and Stone Statue here.

>e
(first opening Heart-painted door)
It seems to be locked.

>w
Small Bedroom
The stink is the first thing noted in this room. The second is the source of the stink. A corpse is laid down on the bed. The small dimension of this room and the corpse on the bed give you a claustrophobia's sensation.

You can see Scratched door, Small Bed (on which is Little Girl's Corpse) and Small Wardrobe (on which is pink dress) here.

>e
Upper Hall
The decoration in this room is creepy. This room has stairs which gives access to the lower floor. And down the stairs, you see the Hall and the Main Door.

You can see Scratched door, Black door, Heart-painted door, Purple door, Stairs and Stone Statue here.

>s
(first opening Purple door)

Bathroom
A bathroom very similar to the last one. There is a corpse on the bathtub emitting a bad smell. A mirror is hanging on the wall and it is broken.

You can see Purple door and Stained Bathtub (on which is Old Man's Corpse) here.

>examine corpse
This man died a long ago. There is something on his chest.

You find a white key in his chest.

>take key
Which do you mean, the White key, the Gray key, the Orange key or Main key?

>white key
You already have that.

>i
You are carrying:
  a White key
  dirty towel
  a Gray key
  wooden planks
  deflated ball
  ruby stone
  an Orange key
  rotten apple
  strange photograph
  candle
  Main key

I beg your pardon?

>w
You can't go that way.

>e
You can't go that way.

>n
Upper Hall
The decoration in this room is creepy. This room has stairs which gives access to the lower floor. And down the stairs, you see the Hall and the Main Door.

You can see Purple door, Scratched door, Black door, Heart-painted door, Stairs and Stone Statue here.

>use stairs
I didn't understand that number.

>climb stairs
Before going down the stairs you softly touch the first step. Everything seems right. The stair acts normally.

Hall
The room is dark and difficult to see without light.

You can see Gray door, Stairs, Red door, Main door and Wooden Table (on which is family photograph) here.

>n
Living Room
This room is oddly empty, like a hurricane has passed by removing all the furniture. Only 4 doors can be seen.

You can see Red door, Brown door, Yellow door and White door here.

>unlokc white door
I didn't understand that number.

>unlock white door
What do you want to unlock White door with?

>white key
You unlock White door.

>enter white door
(first opening White door)

Home Office
This room looks like a professional office. A desk with papers can be seen and behind it, there is a safe box on the corner.

You can see White door, Safe Box (closed) and Writing Desk (on which is mysterious photograph) here.

>examine mysterious photograph
The photo shows two kids hugging themselves and smiling to the camera. Behind them you can see the house. And if you look closer, you can see a strange figure with 2 glowing red eyes looking to the kids.

>examine safe box
A locked safe box. It looks like it holds something valuable. Maybe the code is hidden somewhere in the house

>examine writing desk
Full of papers.

On Writing Desk is mysterious photograph.

>a
I didn't understand that number.

>w
Living Room
This room is oddly empty, like a hurricane has passed by removing all the furniture. Only 4 doors can be seen.

You can see White door, Red door, Brown door and Yellow door here.

>s
Hall
The room is dark and difficult to see without light.

You can see Red door, Gray door, Stairs, Main door and Wooden Table (on which is family photograph) here.

>e
Lavabo
There was a good reason the door was closed. The toilet is unusable. The smell is as bad as in the kitchen. A mirror hanging on the wall attracts  your attention.

You can see Gray door, Old Mirror, Toilet and Wash Basin here.

>examine mirror
The mirror frame is made of gold. Well detailed. When look inside the mirror you see... another room?

You put the finger inside the mirror. It disappears. You put your hole hand and it also disappears. You don't think twice. You enter with all your body in the mirror. First you start to fell dizzy. Then things become worse. It is like your soul was taken off your body and travelled in an infinite speed. You see thousands of things and nothing at the same time. You cannot know if 5 seconds has passed or 5 days. It is the most painful sensation you have ever experienced. 
Inner Bathroom
The decoration on this room is very similar to the other rooms. The mirror hanging on the wall is identical to the mirror in the lavabo.

You can see Blue door, Marble Wash Basin (on which is Soap), Bathtub, Dirty Mirror and Marble Toilet here.

>w
Large Bedroom
This bedroom is very large. The windows are covered by wood planks, but a hole on the ceiling allows the light to enter on the room. A beautiful painting is hanging on the wall.

You can see Black door, Blue door, Beautiful Painting, Large Bed and Wardrobe (in which is moldy shirt) here.

>examine painting
A beautifull painting decoring the wall. You have a feel that you have already seen this painting somewhere.

Behind the painting is written 314. You write the sequence in a piece of paper. Maybe It will be usefull.

>s
Upper Hall
The decoration in this room is creepy. This room has stairs which gives access to the lower floor. And down the stairs, you see the Hall and the Main Door.

You can see Black door, Stairs, Purple door, Scratched door, Heart-painted door and Stone Statue here.

>climb stairs
Before going down the stairs you softly touch the first step. Everything seems right. The stair acts normally.

Hall
The room is dark and difficult to see without light.

You can see Gray door, Stairs, Red door, Main door and Wooden Table (on which is family photograph) here.

>n
Living Room
This room is oddly empty, like a hurricane has passed by removing all the furniture. Only 4 doors can be seen.

You can see Red door, White door, Brown door and Yellow door here.

>e
Home Office
This room looks like a professional office. A desk with papers can be seen and behind it, there is a safe box on the corner.

You can see White door, Safe Box (closed) and Writing Desk (on which is mysterious photograph) here.

>safe box
I didn't understand that number.

>examine safe box
A locked safe box. It looks like it holds something valuable. Maybe the code is hidden somewhere in the house

>unlock safe box
What do you want to unlock Safe Box with?

>i
You are carrying:
  a number sequence
  a White key
  dirty towel
  a Gray key
  wooden planks
  deflated ball
  ruby stone
  an Orange key
  rotten apple
  strange photograph
  candle
  Main key

>number sequence
I didn't understand that number.

>unlock safe box
What do you want to unlock Safe Box with?

>number sequence
That doesn't seem to fit the lock.

* * *

>i
You are carrying:
  a number sequence
  a White key
  dirty towel
  a Gray key
  wooden planks
  deflated ball
  ruby stone
  an Orange key
  rotten apple
  strange photograph
  candle
  Main key

>unlock safe box
What do you want to unlock Safe Box with?

>number sequence
You unlock Safe Box.

>open safe box
You open Safe Box, revealing battery.

>i
You are carrying:
  a number sequence
  a White key
  dirty towel
  a Gray key
  wooden planks
  deflated ball
  ruby stone
  an Orange key
  rotten apple
  strange photograph
  candle
  Main key

>e
You can't go that way.

>w
Living Room
This room is oddly empty, like a hurricane has passed by removing all the furniture. Only 4 doors can be seen.

You can see White door, Red door, Brown door and Yellow door here.

* * *

>e
Lavabo
There was a good reason the door was closed. The toilet is unusable. The smell is as bad as in the kitchen. A mirror hanging on the wall attracts  your attention.

You can see Gray door, Old Mirror, Toilet and Wash Basin here.

>a
I didn't understand that number.

>w
Hall
The room is dark and difficult to see without light.

You can see Gray door, Red door, Stairs, Main door and Wooden Table (on which is family photograph) here.

>n
Living Room
This room is oddly empty, like a hurricane has passed by removing all the furniture. Only 4 doors can be seen.

You can see Red door, White door, Brown door and Yellow door here.

>n
Dining Room
The dining room looks like to be more conserved than the other rooms. The forniture is fancy, but very strange.

You can see Yellow door, Green door, Large Wooden Table, Old Chair and Shelf here.

>e
You can't go that way.

>w
Kitchen
It seems to be a normal kitchen, but not used for a long time. There are rotten food in the cabinet and a few dead rats on the floor. The smell is intolerable. You feel seasick only by staying in this room.

You can see Green door, Orange door, Furnace (on which is old pressure cooker), Simple Table (on which is dirty napkin) and Cabinet (empty) here.

>s
We have a deal and I'm here to give to you something.

1: "I got this ruby stone, take it."

>1
1: "I got this ruby stone, take it."

"Wow! Very good treasure!
I have a gift for you.
The homeless gaves you another key." he replies.

>look
Garage
The garage is fully of rotten boxes. A weak light beam comes from a small window. The smell is bad, but is a relief compared to the kitchen.

You can see Brown door, Orange door and Charles here.

>i
You are carrying:
  a Heartshaped key
  a number sequence
  a White key
  dirty towel
  a Gray key
  wooden planks
  deflated ball
  an Orange key
  rotten apple
  strange photograph
  candle
  Main key

>n
Kitchen
It seems to be a normal kitchen, but not used for a long time. There are rotten food in the cabinet and a few dead rats on the floor. The smell is intolerable. You feel seasick only by staying in this room.

You can see Orange door, Green door, Furnace (on which is old pressure cooker), Simple Table (on which is dirty napkin) and Cabinet (empty) here.

* * *

>e
Dining Room
The dining room looks like to be more conserved than the other rooms. The forniture is fancy, but very strange.

You can see Green door, Yellow door, Large Wooden Table, Old Chair and Shelf here.

>s
Living Room
This room is oddly empty, like a hurricane has passed by removing all the furniture. Only 4 doors can be seen.

You can see Brown door, Yellow door, Red door and White door here.

>s
Hall
The room is dark and difficult to see without light.

You can see Red door, Gray door, Stairs, Main door and Wooden Table (on which is family photograph) here.

* * *

>w
Large Bedroom
This bedroom is very large. The windows are covered by wood planks, but a hole on the ceiling allows the light to enter on the room. A beautiful painting is hanging on the wall.

You can see Black door, Blue door, Beautiful Painting, Large Bed and Wardrobe (in which is moldy shirt) here.

>s
Upper Hall
The decoration in this room is creepy. This room has stairs which gives access to the lower floor. And down the stairs, you see the Hall and the Main Door.

You can see Black door, Stairs, Purple door, Scratched door, Heart-painted door and Stone Statue here.

>unlock Heart-painted door
What do you want to unlock Heart-painted door with?

>heart-painted key
I only understood you as far as wanting to unlock Heart-painted door with Heart-painted door.

>unlock Heart-painted door
What do you want to unlock Heart-painted door with?

>Heartshaped key
You unlock Heart-painted door.

>enter Heart-painted door
(first opening Heart-painted door)

Medium Bedroom
This room gives an impression that it is the core of the house, but you don't know why. Another corpse is in the bed, however there is no stink. The corpse seens prety different from the others.

You can see Heart-painted door here.

Entering in the last room of the house, you think nothing can surprise you any longer. You are wrong. You see the most bizarre scene you have ever seen. An old woman, with her skin as white as snow is laid on the bed. A dozen of tree branches are invading her body. Your first thought is that she is dead. But you see she trying to breathe, almost suffocating, while the branches are changing color as if they were taken energy from that old woman.
 Only after a few seconds you see another person standing in the room. The scene was so shocking that you didn't notice him before. It is Charles. When you start to feel a little better for being a familiar face, he starts to talk. His voice is totally different now. He revels that he is no homeless. He always lived in that house, and the woman laid in the bed is his mother. You notice that his right hand is behind his back.
 He tells you that the house needs to be feed. That "she" needs a host. And her mother is no longer strong enough. He moves his right hand, and you can see that he is holding a piece of wood with nails. He runs towards you prepared to attack.
Suddenly, the dog you helped before appears behind you and protect you from the Charles" attack. He bites the arm of the man and the man screams of pain and fall on the floor. You profited his position to kick him in the face, knocking him out. The dog runs through the door, in direction of the exit and you follow him.
 You escaped from the most dangerous situation that you have ever lived or will live. Thanks to your kind soul, you helped a poor animal before entering the house. This dog never forgot you and in your greatest need, he was there to help you. Congratulations Carlos. You have visited all the rooms in the house and completed your job. But, most important, you now have a companion dog.

 GOOD ENDING. Congratulations!

    *** The End ***

Would you like to RESTART, RESTORE a saved game, QUIT or UNDO the last command?

* * *

>examine box
In Old box are candle and string.

* * *

>examine main key
An old and robust key. It seems like it is not used for more than 10 years. Probably opens the Main Door.

* * *

>interact with dog
Ass 2.

* * *

>look
Porch
Descrição Porch.

You can see Main door, Main key, Wooden chair, Old box (in which are candle and string), bucket (empty) and a bear trap (in which is dog) here.

>take trap
You should try open the trap.

>help dog
That's not a verb I recognise.

>unlock trap
What do you want to unlock the bear trap with?

>nothing
You can't see any such thing.

>examine bear trap
In the bear trap is dog.

>open beartrap
You can't see any such thing.

>open bear trap
It isn't something you can open.

>look
Porch
Descrição Porch.

You can see Main door, Main key, Wooden chair, Old box (in which are candle and string), bucket (empty) and a bear trap (in which is dog) here.

>open bear trap
It isn't something you can open.

>unlock bear trap
What do you want to unlock the bear trap with?

>main key
(first taking Main key)
A chill runs up your spine
That doesn't seem to be something you can unlock.

>help dog
That's not a verb I recognise.

>take dog
Taken.

* * *

>move to living room
A chill runs up your spine
(first opening Main door)
(first opening Red door)
Now you are in the Living Room

>go south
Hall
The room is dark and difficult to see without light.

The stairs are... weird?

You can also see Red door, Gray door, Main door and Wooden Table (on which is family photograph) here.

The inside smells as bad news...

You hear something knocking the wall out there.

>enter stairs
Upper Hall
The decoration in this room is creepy. This room has stairs which gives access to the lower floor. And down the stairs, you see the Hall and the Main Door.

The stairs are... weird?

You can also see Heart-painted door, Purple door, Black door, Scratched door and Stone Statue here.

>interact with stone statue
You don't have something to interact with this Statue.

You really heard someone shouting in the next room.
You can respond this supplicant or simply ignore it!

>examine stone statue
A scaring statue holding still, like if it is almost moving. You can deduce that it has two ruby eyes. One is in the statue, the other one is missing. Maybe if I find the lost eye, It will be possible to "interact with" the Statue.

The unidentified noise is still coming from the Garage.

* * *

>move to living room
A chill runs up your spine
(first opening Main door)
(first opening Red door)
Now you are in the Living Room

>look
Living Room
This room is oddly empty, like a hurricane has passed by removing all the furniture. Only 4 doors can be seen.

You can see White door, Red door, Brown door and Yellow door here.

You hear something knocking the wall out there.

>hear supplicant
You can't reach into Garage.

>respond supplicant
The homeless introduced himself to you and his name is Charles.
Maybe he has something to tell you...

You really heard someone shouting in the next room.
You can respond this supplicant or simply ignore it!

>respond
(Main key)
Talking to objects? You're maybe mad

>respond supplicant
You see nothing special about Charles.

>talk to charles
1: "Who are you?"
2: "Where are you"
3: "Why are you there?"

>2
2: "Where are you"

"I am locked in the Garage room." he replies.
1: "Who are you?"
2: "Why are you there?"

>2
2: "Why are you there?"

"I was looking for some gods in this abandoned house and I got locked here after falling through the tipper 
Could you help me? I have a god to you!

1: "Yes"
1: "No"

You are alone again, no more conversations.

>1
1: "Yes"

"Fine, follow my instructions." he replies.

You are alone again, no more conversations.

>2
No such option is available.

* * *

>move to living room
A chill runs up your spine
(first opening Main door)
(first opening Red door)
Now you are in the Living Room

>z
Time passes.

You hear something knocking the wall out there.

* * *

>open bear trap
It isn't something you can open.

* * *

>open main door
It seems to be locked.

>use main ky
That's not a verb I recognise.

>unlock main door
What do you want to unlock Main door with?

* * *

>main key
(first taking Main key)
A chill runs up your spine
You unlock Main door.

>enter main door
(first opening Main door)

Hall
You can see Main door here.

The inside smells as bad news...

>go north
Living Room
The lavabo needs to be cleaned.

* * *

>play until living
Go away dog!

You saved the dog from the trap. He is very thankful.

A chill runs up your spine
(first opening Main door)
I should examine it.

Giving a closer look on the photo you see two kids, a boy and a girl, with their parents. Behind them, there is a house being constructed.

(first opening Red door)

Living Room
This room is oddly empty, like a hurricane has passed by removing all the furniture. Only 4 doors can be seen.

You can see White door, Red door, Brown door and Yellow door here.

>play to garage
(first opening Yellow door)

Dining Room
The dining room looks like to be more conserved than the other rooms. The forniture is fancy, but very strange.

You can see Yellow door, Green door, Large Wooden Table (on which is fresh apple), Old Chair and Shelf (on which is strange photograph) here.

Suddenly, the apple begins to rot in your hands, the radio turn on and start to play strange sounds. You can hear strange heart beats coming from the eletronic device.

Giving a closer look on the photo you see two kids, a boy and a girl, with their parents. Behind them, there is a house being constructed.

(first opening Green door)

Kitchen
It seems to be a normal kitchen, but not used for a long time. There are rotten food in the cabinet and a few dead rats on the floor. The smell is intolerable. You feel seasick only by staying in this room.

You can see Green door, Orange door, Furnace (on which is old pressure cooker), Simple Table (on which are an Orange key and dirty napkin) and Cabinet (empty) here.

Taken.

You unlock Orange door.

(first opening Orange door)
Garage
The garage is fully of rotten boxes. A weak light beam comes from a small window. The smell is bad, but is a relief compared to the kitchen.

You can see Brown door, Orange door, deflated ball, wooden planks and a homeless here.

Interesting... there is a homeless here!

The homeless introduced himself to you and his name is Charles.
Maybe he has something to tell you...

>talk to charles
1: "Who are you?"
2: "Where are you"
3: "Why are you there?"

>1
1: "Who are you?"

"As I said, my name is Charles. I am a homeless." he replies.
1: "Where are you"
2: "Why are you there?"

You really heard someone shouting in the next room.
You can respond this supplicant or simply ignore it!

>2
2: "Why are you there?"

"I was looking for some gods in this abandoned house and I got locked here after falling through the tipper 
Could you help me? I have a god to you!

Could you help me? I have a god to you!
1: "Yes"
2: "No"

>1
1: "Yes"

"Fine, follow my instructions." he replies.
I am at Garage Room, you need to find a way to open its door!

You are alone again, no more conversations.

* * *

>talk to charles
1: "Who are you?"
2: "Where are you"
3: "Why are you there?"

>3
3: "Why are you there?"

"I was looking for some gods in this abandoned house and I got locked here after falling through the tipper 
Could you help me? I have a god to you!

Could you help me? I have a god to you!
1: "Yes"
2: "No"

>1
1: "Yes"

"Fine, follow my instructions." he replies.
I am at Garage Room, you need to find a way to open its door!

You are alone again, no more conversations.

* * *

>play until living
Go away dog!

You saved the dog from the trap. He is very thankful.

A chill runs up your spine
(first opening Main door)
I should examine it.

Giving a closer look on the photo you see two kids, a boy and a girl, with their parents. Behind them, there is a house being constructed.

(first opening Red door)

Living Room
This room is oddly empty, like a hurricane has passed by removing all the furniture. Only 4 doors can be seen.

You can see White door, Red door, Brown door and Yellow door here.

>z
Time passes.

You hear something knocking the wall out there.

>z
Time passes.

>z
Time passes.

You really heard someone shouting in the next room.
You can respond this supplicant or simply ignore it!

>respond supplicant
The homeless introduced himself to you and his name is Charles.
Maybe he has something to tell you...

>play to garage
(first opening Yellow door)

Dining Room
The dining room looks like to be more conserved than the other rooms. The forniture is fancy, but very strange.

You can see Yellow door, Green door, Large Wooden Table (on which is fresh apple), Old Chair and Shelf (on which is strange photograph) here.

Suddenly, the apple begins to rot in your hands, the radio turn on and start to play strange sounds. You can hear strange heart beats coming from the eletronic device.

Giving a closer look on the photo you see two kids, a boy and a girl, with their parents. Behind them, there is a house being constructed.

(first opening Green door)

Kitchen
It seems to be a normal kitchen, but not used for a long time. There are rotten food in the cabinet and a few dead rats on the floor. The smell is intolerable. You feel seasick only by staying in this room.

You can see Green door, Orange door, Furnace (on which is old pressure cooker), Simple Table (on which are an Orange key and dirty napkin) and Cabinet (empty) here.

Taken.

You unlock Orange door.

(first opening Orange door)
Garage
The garage is fully of rotten boxes. A weak light beam comes from a small window. The smell is bad, but is a relief compared to the kitchen.

You can see Brown door, Orange door, deflated ball, wooden planks and Charles here.

Okay... here is the homeless! Maybe you can help him.

>talk to charles
1: "Who are you?"
2: "Where are you"
3: "Why are you there?"

* * *

>respond supplicant
The homeless introduced himself to you and his name is Charles.
Maybe he has something to tell you...

>talk to charles
1: "Who are you?"
2: "Where are you"
3: "Why are you there?"

* * *

>1
1: "Yes"

"Fine, follow my instructions." he replies.
I am at Garage Room, you need to find a way to open its door!

You are alone again, no more conversations.

>play to garage
(first opening Yellow door)

Dining Room
The dining room looks like to be more conserved than the other rooms. The forniture is fancy, but very strange.

You can see Yellow door, Green door, Large Wooden Table (on which is fresh apple), Old Chair and Shelf (on which is strange photograph) here.

Suddenly, the apple begins to rot in your hands, the radio turn on and start to play strange sounds. You can hear strange heart beats coming from the eletronic device.

Giving a closer look on the photo you see two kids, a boy and a girl, with their parents. Behind them, there is a house being constructed.

(first opening Green door)

Kitchen
It seems to be a normal kitchen, but not used for a long time. There are rotten food in the cabinet and a few dead rats on the floor. The smell is intolerable. You feel seasick only by staying in this room.

You can see Green door, Orange door, Furnace (on which is old pressure cooker), Simple Table (on which are an Orange key and dirty napkin) and Cabinet (empty) here.

Taken.

You unlock Orange door.

(first opening Orange door)
As you enter the room, immediately you found the homeless.
He is hurt.
Tell something to him.

1: "Ok, here I am. You can go away"
2: "Ohh, here you are... You are hurt? Needs more help?"

>2
2: "Ohh, here you are... You are hurt? Needs more help?"

"No, I am fine. Just a pain in my legs, thats okay.
Take a key I found in the Hall, it can be useful to you." he replies.
You pick the key from homeless.

>inventory
You are carrying:
  a Gray key
  an Orange key
  rotten apple
  family photograph
  Main key

* * *

>play until living room
I didn't understand that sentence.

>play until living
Go away dog!

You saved the dog from the trap. He is very thankful.

A chill runs up your spine
(first opening Main door)
I should examine it.

Giving a closer look on the photo you see two kids, a boy and a girl, with their parents. Behind them, there is a house being constructed.

(first opening Red door)

Living Room
This room is oddly empty, like a hurricane has passed by removing all the furniture. Only 4 doors can be seen.

You can see White door, Red door, Brown door and Yellow door here.

* * *

>z
Time passes.

You really heard someone shouting in the next room.
You can respond this supplicant or simply ignore it!

>play to garage
(first opening Yellow door)

Dining Room
The dining room looks like to be more conserved than the other rooms. The forniture is fancy, but very strange.

You can see Yellow door, Green door, Large Wooden Table (on which is fresh apple), Old Chair and Shelf (on which is strange photograph) here.

Suddenly, the apple begins to rot in your hands, the radio turn on and start to play strange sounds. You can hear strange heart beats coming from the eletronic device.

Giving a closer look on the photo you see two kids, a boy and a girl, with their parents. Behind them, there is a house being constructed.

(first opening Green door)

Kitchen
It seems to be a normal kitchen, but not used for a long time. There are rotten food in the cabinet and a few dead rats on the floor. The smell is intolerable. You feel seasick only by staying in this room.

You can see Green door, Orange door, Furnace (on which is old pressure cooker), Simple Table (on which are an Orange key and dirty napkin) and Cabinet (empty) here.

Taken.

You unlock Orange door.

(first opening Orange door)
Garage
The garage is fully of rotten boxes. A weak light beam comes from a small window. The smell is bad, but is a relief compared to the kitchen.

You can see Brown door, Orange door, deflated ball, wooden planks and a homeless here.

Interesting... there is a homeless here!

The homeless introduced himself to you and his name is Charles.
Maybe he has something to tell you...

* * *

>play until living;
I didn't understand that sentence.

>play until living
Go away dog!

You saved the dog from the trap. He is very thankful.

A chill runs up your spine
(first opening Main door)
I should examine it.

Giving a closer look on the photo you see two kids, a boy and a girl, with their parents. Behind them, there is a house being constructed.

(first opening Red door)

Living Room
This room is oddly empty, like a hurricane has passed by removing all the furniture. Only 4 doors can be seen.

You can see White door, Red door, Brown door and Yellow door here.

* * *

>put
What do you want to put?

* * *

>unlock main door
What do you want to unlock Main door with?

* * *

>main key
(first taking Main key)
A chill runs up your spine
You unlock Main door.

>enter main door
(first opening Main door)

Hall
The room is dark and difficult to see without light.

The stairs are... weird?

You can also see Gray door, Main door, Red door and Wooden Table (on which is family photograph) here.

The inside smells as bad news...

>enter stairs
Upper Hall
The decoration in this room is creepy. This room has stairs which gives access to the lower floor. And down the stairs, you see the Hall and the Main Door.

The stairs are... weird?

You can also see Heart-painted door, Purple door, Black door, Scratched door and Stone Statue here.

>put main key
Ass.

* * *

>release dog
Go away dog!

You saved the dog from the trap. He is very thankful.

>look
Porch
The entrance shows the house's condition. Old and abandoned.

You can see dog, Main door, Main key, Wooden chair, Old box (in which are candle and string), bucket (empty) and a bear trap (empty) here.

>examine dog
A hazed dog. His leg seems pretty hurt.

>examine main door
A huge and heavy door. It looks likes to be the only properly way to enter on the house.

>examine main key
An old and robust key. It seems like it is not used for more than 10 years. Probably opens the Main Door.

>take main key
A chill runs up your spine
Taken.

>examine wooden chair
You see nothing special about Wooden chair.

>candle
I didn't understand that number.

>examine candle
A used candle. Perhaps it can still illuminate a dark room.

>take candle
Taken.

>unlock main door
What do you want to unlock Main door with?

>main key
You unlock Main door.

>enter main door
(first opening Main door)

Hall
The room is dark and difficult to see without light.

The stairs are... weird?

You can also see Gray door, Main door, Red door and Wooden Table (on which is family photograph) here.

The inside smells as bad news...

* * *

>take key
(Main key)
A chill runs up your spine
Taken.

>open door
It seems to be locked.

>unlock door
(with Main key)
You unlock Main door.

>enter door
(first opening Main door)

Hall
The room is dark and difficult to see without light.

You can see Gray door, Main door, Red door, Stairs and Wooden Table (on which is family photograph) here.

The inside smells as bad news...

>look photo
You can't see any such thing.

>take photo
You can't see any such thing.

>take photograph
I should examine it.

>examine photografy
You can't see any such thing.

>examine photograph
Giving a closer look on the photo you see two kids, a boy and a girl, with their parents. Behind them, there is a house being constructed.

>north
(first opening Red door)

Living Room
This room is oddly empty, like a hurricane has passed by removing all the furniture. Only 4 doors can be seen.

You can see White door, Red door, Brown door and Yellow door here.

>north
(first opening Yellow door)

Dining Room
The dining room looks like to be more conserved than the other rooms. The forniture is fancy, but very strange.

You can see Yellow door, Green door, Large Wooden Table (on which is fresh apple), Old Chair and Shelf (on which is strange photograph) here.

>take apple
Suddenly, the apple begins to rot in your hands, the radio turn on and start to play strange sounds. You can hear strange heart beats coming from the eletronic device.

>look
Dining Room
The dining room looks like to be more conserved than the other rooms. The forniture is fancy, but very strange.

You can see Yellow door, Green door, Large Wooden Table, Old Chair and Shelf (on which is strange photograph) here.

>take photograph
(strange photograph)
I should take a closer look.

>look photograph
Which do you mean, strange photograph or family photograph?

>east
I only understood you as far as wanting to look east.

>east
You can't go that way.

>west
(first opening Green door)

Kitchen
It seems to be a normal kitchen, but not used for a long time. There are rotten food in the cabinet and a few dead rats on the floor. The smell is intolerable. You feel seasick only by staying in this room.

You can see Green door, Orange door, Furnace (on which is old pressure cooker), Simple Table (on which are an Orange key and dirty napkin) and Cabinet (empty) here.

>take orange key
Taken.

>unlock orange door
What do you want to unlock Orange door with?

>unlock orange door with orange key
You unlock Orange door.

>enter orange door
(first opening Orange door)
Garage
The garage is fully of rotten boxes. A weak light beam comes from a small window. The smell is bad, but is a relief compared to the kitchen.

You can see Brown door, Orange door, deflated ball, wooden planks and a homeless here.

Interesting... there is a homeless here!

The homeless introduced himself to you and his name is Charles.
Maybe he has something to tell you...

>look
Garage
The garage is fully of rotten boxes. A weak light beam comes from a small window. The smell is bad, but is a relief compared to the kitchen.

You can see Brown door, Orange door, deflated ball, wooden planks and Charles here.

* * *

>north
(first opening Red door)

Living Room
This room is oddly empty, like a hurricane has passed by removing all the furniture. Only 4 doors can be seen.

You can see White door, Red door, Brown door and Yellow door here.

>z
Time passes.

>z
Time passes.

* * *

>release dog
Go away dog!

You saved the dog from the trap. He is very thankful.

>unlock main door
What do you want to unlock Main door with?

* * *

>enter main door
(first opening Main door)

Hall
The room is dark and difficult to see without light.

The stairs are... weird?

You can also see Gray door, Main door, Red door and Wooden Table (on which is family photograph) here.

The inside smells as bad news...

>enter red door
(first opening Red door)

Living Room
This room is oddly empty, like a hurricane has passed by removing all the furniture. Only 4 doors can be seen.

You can see White door, Red door, Brown door and Yellow door here.

The End.
Good End. Dog Helps.

    *** The End ***

Would you like to RESTART, RESTORE a saved game, QUIT or UNDO the last command?

* * *

>release dog, take key, open main door, look photo, north
You can't use multiple objects with that verb.

>release dog\ take key
You can't see any such thing.

>release dog / take key
I only understood you as far as wanting to release dog.

>release dog; take key
You can't see any such thing.

>release dog / take key
I only understood you as far as wanting to release dog.

* * *

>take all
Main key: A chill runs up your spine
Taken.
Old box: Taken.
bucket: Taken.
bear trap: Taken.
candle: Taken.
string: Taken.
dog: You should try to release the dog.

>i
You are carrying:
  string
  candle
  a bear trap
    dog
  bucket
  Old box
  Main key

>use main key in main door
I didn't understand that number.

>unlock main door with main key
You unlock Main door.

>enter main door
(first opening Main door)

Hall
The room is dark and difficult to see without light.

You can see Gray door, Main door, Red door, Stairs and Wooden Table (on which is family photograph) here.

The inside smells as bad news...

>n
(first opening Red door)

Living Room
This room is oddly empty, like a hurricane has passed by removing all the furniture. Only 4 doors can be seen.

You can see White door, Red door, Brown door and Yellow door here.

* * *

>n
(first opening Yellow door)

Dining Room
The dining room looks like to be more conserved than the other rooms. The forniture is fancy, but very strange.

You can see Yellow door, Green door, Large Wooden Table (on which is fresh apple), Old Chair and Shelf (on which is strange photograph) here.

>e
You can't go that way.

>q
Are you sure you want to quit?

>w
Please answer yes or no.

* * *

>w
(first opening Green door)

Kitchen
It seems to be a normal kitchen, but not used for a long time. There are rotten food in the cabinet and a few dead rats on the floor. The smell is intolerable. You feel seasick only by staying in this room.

You can see Green door, Orange door, Furnace (on which is old pressure cooker), Simple Table (on which are an Orange key and dirty napkin) and Cabinet (empty) here.

>take orange key
Taken.

* * *

>orange key
You unlock Orange door.

>enter orange door
(first opening Orange door)

>look
Garage
The garage is fully of rotten boxes. A weak light beam comes from a small window. The smell is bad, but is a relief compared to the kitchen.

You can see Brown door, Orange door, deflated ball, wooden planks and a homeless here.

>talk to homelless
You can't see any such thing.

>talk to homeless
1: "Who are you?"
2: "Where are you"
3: "Why are you there?"

>3
3: "Why are you there?"

"I was looking for some gods in this abandoned house and I got locked here after falling through the tipper 
Could you help me? I have a god to you!

Could you help me? I have a god to you!
1: "Yes"
2: "No"

* * *

>1
1: "Yes"

"Fine, follow my instructions." he replies.
I am at Garage Room, you need to find a way to open its door!

You are alone again, no more conversations.

>look
Garage
The garage is fully of rotten boxes. A weak light beam comes from a small window. The smell is bad, but is a relief compared to the kitchen.

You can see Brown door, Orange door, deflated ball, wooden planks and a homeless here.

>talk to carlos
You can't see any such thing.

>talk to charles
You can't see any such thing.

>talk to homeless
1: "Ok, here I am. You can go away"
2: "Ohh, here you are... You are hurt? Needs more help?"

>2
2: "Ohh, here you are... You are hurt? Needs more help?"

"No, I am fine. Just a pain in my legs, thats okay.
Take a key I found in the Hall, it can be useful to you." he replies.
You pick the key from homeless.

>n
Kitchen
It seems to be a normal kitchen, but not used for a long time. There are rotten food in the cabinet and a few dead rats on the floor. The smell is intolerable. You feel seasick only by staying in this room.

You can see Orange door, Green door, Furnace (on which is old pressure cooker), Simple Table (on which is dirty napkin) and Cabinet (empty) here.

>e
Dining Room
The dining room looks like to be more conserved than the other rooms. The forniture is fancy, but very strange.

You can see Green door, Yellow door, Large Wooden Table (on which is fresh apple), Old Chair and Shelf (on which is strange photograph) here.

>s
Living Room
This room is oddly empty, like a hurricane has passed by removing all the furniture. Only 4 doors can be seen.

You can see Brown door, Yellow door, White door and Red door here.

* * *

>s
Hall
The room is dark and difficult to see without light.

You can see Red door, Gray door, Main door, Stairs and Wooden Table (on which is family photograph) here.

>unlock gray door with gray key
You unlock Gray door.

>w
You can't go that way.

>e
(first opening Gray door)

Lavabo
There was a good reason the door was closed. The toilet is unusable. The smell is as bad as in the kitchen. A mirror hanging on the wall attracts  your attention.

You can see Gray door, Old Mirror, Toilet, dirty towel and Wash Basin here.

>examine mirror
The mirror frame is made of gold. Well detailed. When look inside the mirror you see... another room?

You put the finger inside the mirror. It disappears. You put your hole hand and it also disappears. You don't think twice. You enter with all your body in the mirror. First you start to fell dizzy. Then things become worse. It is like your soul was taken off your body and travelled in an infinite speed. You see thousands of things and nothing at the same time. You cannot know if 5 seconds has passed or 5 days. It is the most painful sensation you have ever experienced. 
Inner Bathroom
The decoration on this room is very similar to the other rooms. The mirror hanging on the wall is identical to the mirror in the lavabo.

You can see Blue door, Marble Wash Basin (on which is Soap), Bathtub, Dirty Mirror and Marble Toilet here.

>w
Large Bedroom
This bedroom is very large. The windows are covered by wood planks, but a hole on the ceiling allows the light to enter on the room. A beautiful painting is hanging on the wall.

You can see Blue door, Black door, Beautiful Painting, Large Bed and Wardrobe (in which is moldy shirt) here.

>s
(first opening Black door)

Upper Hall
The decoration in this room is creepy. This room has stairs which gives access to the lower floor. And down the stairs, you see the Hall and the Main Door.

You can see Heart-painted door, Purple door, Black door, Stairs, Scratched door and Stone Statue here.

>n
Large Bedroom
This bedroom is very large. The windows are covered by wood planks, but a hole on the ceiling allows the light to enter on the room. A beautiful painting is hanging on the wall.

You can see Black door, Blue door, Beautiful Painting, Large Bed and Wardrobe (in which is moldy shirt) here.

>examine beautiful
A beautifull painting decoring the wall. You have a feel that you have already seen this painting somewhere.

Behind the painting is written 314. You write the sequence in a piece of paper. Maybe It will be usefull.

>s
Upper Hall
The decoration in this room is creepy. This room has stairs which gives access to the lower floor. And down the stairs, you see the Hall and the Main Door.

You can see Black door, Heart-painted door, Purple door, Stairs, Scratched door and Stone Statue here.

>e
(first opening Heart-painted door)
It seems to be locked.

>w
(first opening Scratched door)

Small Bedroom
The stink is the first thing noted in this room. The second is the source of the stink. A corpse is laid down on the bed. The small dimension of this room and the corpse on the bed give you a claustrophobia's sensation.

You can see Scratched door, Small Bed (on which is Little Girl's Corpse) and Small Wardrobe (on which is pink dress) here.

>e
Upper Hall
The decoration in this room is creepy. This room has stairs which gives access to the lower floor. And down the stairs, you see the Hall and the Main Door.

You can see Scratched door, Black door, Heart-painted door, Purple door, Stairs and Stone Statue here.

* * *

>examine corpse
This man died a long ago. There is something on his chest.

You find a white key in his chest.

>i
You are carrying:
  a White key
  a number sequence
  a Gray key
  an Orange key
  string
  candle
  a bear trap
    dog
  bucket
  Old box
  Main key

>n
Upper Hall
The decoration in this room is creepy. This room has stairs which gives access to the lower floor. And down the stairs, you see the Hall and the Main Door.

You can see Purple door, Scratched door, Black door, Heart-painted door, Stairs and Stone Statue here.

>climb stairs
Before going down the stairs you softly touch the first step. Everything seems right. The stair acts normally.

Hall
The room is dark and difficult to see without light.

You can see Gray door, Stairs, Red door, Main door and Wooden Table (on which is family photograph) here.

* * *

>n
Living Room
This room is oddly empty, like a hurricane has passed by removing all the furniture. Only 4 doors can be seen.

You can see Red door, Brown door, Yellow door and White door here.

>n
Dining Room
The dining room looks like to be more conserved than the other rooms. The forniture is fancy, but very strange.

You can see Yellow door, Green door, Large Wooden Table (on which is fresh apple), Old Chair and Shelf (on which is strange photograph) here.

>examine photograph
You see nothing special about strange photograph.

There is a old woman writing or drawing something behind a painting.

>s
Living Room
This room is oddly empty, like a hurricane has passed by removing all the furniture. Only 4 doors can be seen.

You can see Yellow door, Red door, Brown door and White door here.

>s
Hall
The room is dark and difficult to see without light.

You can see Red door, Gray door, Stairs, Main door and Wooden Table (on which is family photograph) here.

>examine photograph
Giving a closer look on the photo you see two kids, a boy and a girl, with their parents. Behind them, there is a house being constructed.

>take photograph
I should examine it.

>w
You can't go that way.

>n
Living Room
This room is oddly empty, like a hurricane has passed by removing all the furniture. Only 4 doors can be seen.

You can see Red door, Yellow door, Brown door and White door here.

>unlock white door with white key
You unlock White door.

>enter white door
(first opening White door)

Home Office
This room looks like a professional office. A desk with papers can be seen and behind it, there is a safe box on the corner.

You can see White door, Safe Box (closed) and Writing Desk (on which is mysterious photograph) here.

>unlock safe box
What do you want to unlock Safe Box with?

>number
You unlock Safe Box.

>i
You are carrying:
  family photograph
  a White key
  a number sequence
  a Gray key
  an Orange key
  string
  candle
  a bear trap
    dog
  bucket
  Old box
  Main key

>open safe box
You open Safe Box, revealing ruby stone.

>i
You are carrying:
  family photograph
  a White key
  a number sequence
  a Gray key
  an Orange key
  string
  candle
  a bear trap
    dog
  bucket
  Old box
  Main key

>e
You can't go that way.

>w
Living Room
This room is oddly empty, like a hurricane has passed by removing all the furniture. Only 4 doors can be seen.

You can see White door, Red door, Yellow door and Brown door here.

>s
Hall
The room is dark and difficult to see without light.

You can see Red door, Gray door, Stairs, Main door and Wooden Table here.

>e
Lavabo
There was a good reason the door was closed. The toilet is unusable. The smell is as bad as in the kitchen. A mirror hanging on the wall attracts  your attention.

You can see Gray door, Old Mirror, Toilet, dirty towel and Wash Basin here.

>examine mirror
The mirror frame is made of gold. Well detailed. When look inside the mirror you see... another room?

You put the finger inside the mirror. It disappears. You put your hole hand and it also disappears. You don't think twice. You enter with all your body in the mirror. First you start to fell dizzy. Then things become worse. It is like your soul was taken off your body and travelled in an infinite speed. You see thousands of things and nothing at the same time. You cannot know if 5 seconds has passed or 5 days. It is the most painful sensation you have ever experienced. 
Inner Bathroom
The decoration on this room is very similar to the other rooms. The mirror hanging on the wall is identical to the mirror in the lavabo.

You can see Blue door, Marble Wash Basin (on which is Soap), Bathtub, Dirty Mirror and Marble Toilet here.

* * *

>s
Upper Hall
The decoration in this room is creepy. This room has stairs which gives access to the lower floor. And down the stairs, you see the Hall and the Main Door.

You can see Black door, Stairs, Purple door, Scratched door, Heart-painted door and Stone Statue here.

>examine stone
A scaring statue holding still, like if it is almost moving. You can deduce that it has two ruby eyes. One is in the statue, the other one is missing. Maybe if I find the lost eye, It will be possible to "interact with" the Statue.

>put ruby
You can't see any such thing.

>interact with statue
You don't have something to interact with this Statue.

>interact with Stone Statue
You don't have something to interact with this Statue.

>i
You are carrying:
  family photograph
  a White key
  a number sequence
  a Gray key
  an Orange key
  string
  candle
  a bear trap
    dog
  bucket
  Old box
  Main key

>climb satir
You can't see any such thing.

>climb stairs
Before going down the stairs you softly touch the first step. Everything seems right. The stair acts normally.

Hall
The room is dark and difficult to see without light.

You can see Gray door, Stairs, Red door, Main door and Wooden Table here.

>n
Living Room
This room is oddly empty, like a hurricane has passed by removing all the furniture. Only 4 doors can be seen.

You can see Red door, White door, Yellow door and Brown door here.

>e
Home Office
This room looks like a professional office. A desk with papers can be seen and behind it, there is a safe box on the corner.

You can see White door, Safe Box (in which is ruby stone) and Writing Desk (on which is mysterious photograph) here.

>open safe box
That's already open.

>take ruby
Taken.

>w
Living Room
This room is oddly empty, like a hurricane has passed by removing all the furniture. Only 4 doors can be seen.

You can see White door, Red door, Yellow door and Brown door here.

* * *

>s
Upper Hall
The decoration in this room is creepy. This room has stairs which gives access to the lower floor. And down the stairs, you see the Hall and the Main Door.

You can see Black door, Stairs, Purple door, Scratched door, Heart-painted door and Stone Statue here.

>interact with Stone
(ruby stone)

>yes
That was a rhetorical question.

I beg your pardon?

>ruby
I didn't understand that number.

I beg your pardon?

>look
Upper Hall
The decoration in this room is creepy. This room has stairs which gives access to the lower floor. And down the stairs, you see the Hall and the Main Door.

You can see Black door, Stairs, Purple door, Scratched door, Heart-painted door and Stone Statue here.

>climb stairs
Before going down the stairs you softly touch the first step. Everything seems right. The stair acts normally.

Hall
The room is dark and difficult to see without light.

You can see Gray door, Stairs, Red door, Main door and Wooden Table here.

* * *

>n
Living Room
This room is oddly empty, like a hurricane has passed by removing all the furniture. Only 4 doors can be seen.

You can see Red door, White door, Yellow door and Brown door here.

>e
Home Office
This room looks like a professional office. A desk with papers can be seen and behind it, there is a safe box on the corner.

You can see White door, Safe Box (empty) and Writing Desk (on which is mysterious photograph) here.

>s
You can't go that way.

>e
You can't go that way.

* * *

>w
Living Room
This room is oddly empty, like a hurricane has passed by removing all the furniture. Only 4 doors can be seen.

You can see White door, Red door, Yellow door and Brown door here.

>n
Dining Room
The dining room looks like to be more conserved than the other rooms. The forniture is fancy, but very strange.

You can see Yellow door, Green door, Large Wooden Table (on which is fresh apple), Old Chair and Shelf (on which is strange photograph) here.

>e
You can't go that way.

>s
Living Room
This room is oddly empty, like a hurricane has passed by removing all the furniture. Only 4 doors can be seen.

You can see Yellow door, White door, Red door and Brown door here.

>n
Dining Room
The dining room looks like to be more conserved than the other rooms. The forniture is fancy, but very strange.

You can see Yellow door, Green door, Large Wooden Table (on which is fresh apple), Old Chair and Shelf (on which is strange photograph) here.

>w
Kitchen
It seems to be a normal kitchen, but not used for a long time. There are rotten food in the cabinet and a few dead rats on the floor. The smell is intolerable. You feel seasick only by staying in this room.

You can see Green door, Orange door, Furnace (on which is old pressure cooker), Simple Table (on which is dirty napkin) and Cabinet (empty) here.

* * *

>1
1: "I got this ruby stone, take it."

"Wow! Very good treasure!
I have a gift for you.
The homeless gaves you another key." he replies.

I beg your pardon?

* * *

>s
Living Room
This room is oddly empty, like a hurricane has passed by removing all the furniture. Only 4 doors can be seen.

You can see Brown door, Yellow door, White door and Red door here.

>s
Hall
The room is dark and difficult to see without light.

You can see Red door, Gray door, Stairs, Main door and Wooden Table here.

* * *

>s
Upper Hall
The decoration in this room is creepy. This room has stairs which gives access to the lower floor. And down the stairs, you see the Hall and the Main Door.

You can see Black door, Stairs, Purple door, Scratched door, Heart-painted door and Stone Statue here.

>unlock heart-painted door
What do you want to unlock Heart-painted door with?

>heartshaped key
You unlock Heart-painted door.

>e
(first opening Heart-painted door)

Medium Bedroom
This room gives an impression that it is the core of the house, but you don't know why. Another corpse is in the bed, however there is no stink. The corpse seens prety different from the others.

You can see Heart-painted door here.

Entering in the last room of the house, you think nothing can surprise you any longer. You are wrong. You see the most bizarre scene you have ever seen. An old woman, with her skin as white as snow is laid on the bed. A dozen of tree branches are invading her body. Your first thought is that she is dead. But you see she trying to breathe, almost suffocating, while the branches are changing color as if they were taken energy from that old woman.
 Only after a few seconds you see another person standing in the room. The scene was so shocking that you didn't notice him before. It is Charles. When you start to feel a little better for being a familiar face, he starts to talk. His voice is totally different now. He revels that he is no homeless. He always lived in that house, and the woman laid in the bed is his mother. You notice that his right hand is behind his back.
 He tells you that the house needs to be feed. That "she" needs a host. And her mother is no longer strong enough. He moves his right hand, and you can see that he is holding a piece of wood with nails. He runs towards you prepared to attack.
You defend yourself putting your write arm in front of your face. The man hits your arm with an unnatural strength and the nails trespasses your skin. You instantly move your arm. The piece of wood is wiped off Charles" hands and is now on the floor. The man is coming once again in your direction. You try to get to the piece of wood, but it is too late. His hands are already involving your neck. There is no point in trying to escape, he is way stronger than you. He raises you in the air and strangles you. Your vision is now blurry. You hear the dog in the porch barking. You still try to hit him in the chest a moment before you fainted.
 When you woke up, you see you are in the same room where the fight took place. You try to move but your body does not answer your commands any longer. You look around and you are laid on the bed, with tree branches all over you body. You try to scream, but you have no voice. You are now part of the bed.

 BAD ENDING.

    *** The End ***

Would you like to RESTART, RESTORE a saved game, QUIT or UNDO the last command?

* * *

>look
Upper Hall
The decoration in this room is creepy. This room has stairs which gives access to the lower floor. And down the stairs, you see the Hall and the Main Door.

You can see Black door, Stairs, Purple door, Scratched door, Heart-painted door and Stone Statue here.

>i
You are carrying:
  ruby stone
  family photograph
  a White key
  a number sequence
  a Gray key
  an Orange key
  string
  candle
  a bear trap
    dog
  bucket
  Old box
  Main key

>interact with Stone Statue
You put the ruby stone in the eye of the statue.  Nothing happens so you turn around and go on with your job... 
But them you hear from behind stones breaking. When you look around you can see the Stone Statue coming alive, with it's red-ruby eyes glowing like you never saw before. The monster begins to walk in your direction. You are mesmerized and can't move a muscle. The statue grabs you neck with both hands and starts to hang you. You hear the dog in the porch barking. You see the hand of the statue going up and them down in your dirrection. And then everything goes dark...

 REALLY BAD ENDING

    *** The End ***

Would you like to RESTART, RESTORE a saved game, QUIT or UNDO the last command?

* * *

>take candle
Taken.

>give
(the homeless candle)
The homeless doesn't seem interested.

>give homeless
(to yourself)
(first taking the homeless man)
You can't give the homeless man to yourself.

* * *

>take dog
You should try to release the dog.

>look
Porch
Descrição Porch.

You can see Main door, Main key, Wooden chair, Old box (in which are candle and string), bucket (empty) and a dog here.

>help dog
That's not a verb I recognise.

* * *

>take dog
You should try to release the dog.

>release dog
Go away dog!

You saved the dog from the trap. He is very thankful.

* * *

>enter main door
(first opening Main door)

Hall
The room is dark and difficult to see without light.

The stairs are... weird?

You can also see Gray door, Main door, Red door and Wooden Table (on which is family photograph) here.

The inside smells as bad news...

>examine wooden table
On Wooden Table is family photograph.

Teleporte, bichouuuuu.

Inner Bathroom
The decoration on this room is very similar to the other rooms. The mirror hanging on the wall is identical to the mirror in the lavabo.

You can see Blue door, Marble Wash Basin (on which is Soap), Bathtub, Dirty Mirror and Marble Toilet here.

* * *

>take dog
You should try to release the dog.

>take main key
A chill runs up your spine
Taken.

>open main door
It seems to be locked.

>unlock door
What do you want to unlock Main door with?

>main key
You unlock Main door.

* * *

>enter stairs
Upper Hall
The decoration in this room is creepy. This room has stairs which gives access to the lower floor. And down the stairs, you see the Hall and the Main Door.

The stairs are... weird?

You can also see Heart-painted door, Purple door, Black door, Scratched door and Stone Statue here.

>enter stairs
Hall
The room is dark and difficult to see without light.

The stairs are... weird?

You can also see Gray door, Main door, Red door and Wooden Table (on which is family photograph) here.

* * *

>examine family photograph
Giving a closer look on the photo you see two kids, a boy and a girl, with their parents. Behind them, there is a house being constructed.

* * *

>take dog
You should try to release the dog.

>unlock main door
(with dog)
That doesn't seem to fit the lock.

>take main key
A chill runs up your spine
Taken.

>unlock main door
What do you want to unlock Main door with?

* * *

>main key
You unlock Main door.

>enter main door
(first opening Main door)

Hall
Descrição Hall.

You can see Gray door, Main door, Red door, Stairs and Wooden Table (on which is family photograph) here.

The inside smells as bad news...

>enter red door
(first opening Red door)

Living Room
Descrição Living Room.

You can see White door, Red door, Brown door and Yellow door here.

Assim que você entra no cômodo você ouve gritos de socorro vindo da esquerda, da porta marrom. 
Um homem grita por ajuda dizendo que caiu pelo basculhante e não consegue mais sair.

>enter brown door
(first opening Brown door)
It seems to be locked.

>enter yellow door
(first opening Yellow door)

Dining Room
Descrição Dining Room.

You can see Yellow door, Green door, Large Wooden Table (on which is fresh apple), Old Chair and Shelf (on which is strange photograph) here.

>enter green door
(first opening Green door)

Kitchen
Descrição Kitchen.

Você acredita que esta chave deve abrir a porta laranja, que leva para a garagem da casa. 

You can see Green door, Orange door, Furnace (on which is old pressure cooker), Simple Table (on which is dirty napkin) and Cabinet (empty) here.

>enter orange door
(first opening Orange door)
It seems to be locked.

>take dirty napkin
Taken.

>look
Kitchen
Descrição Kitchen.

Você acredita que esta chave deve abrir a porta laranja, que leva para a garagem da casa. 

You can see Green door, Orange door, Furnace (on which is old pressure cooker), Simple Table and Cabinet (empty) here.

>unlock orange door
What do you want to unlock Orange door with?

>orange key
(first taking the Orange key)
You unlock Orange door.

>enter orange door
(first opening Orange door)

Garage
Descrição Garage.

You can see Brown door, Orange door, deflated ball, wooden planks and a homeless here.

"Ah! Finalmente você chegou... Tome isto como recompensa." diz o homem.

>give homeless
What do you want to give the homeless?

>dirty napkin
The homeless doesn't seem interested.

* * *

>give homeless
What do you want to give the homeless?

>list
You can't see any such thing.

>items
That's not a verb I recognise.

>give
What do you want to give the homeless?

>Gray Key
The homeless doesn't seem interested.

>give
What do you want to give the homeless?

>Apple
You can't see any such thing.

* * *

>take frank
I don't suppose Frank would care for that.

>hi frank
That's not a verb I recognise.

>take candle
Taken.

>give candle
(to Frank)
Frank doesn't seem interested.

* * *

>take main key
A chill runs up your spine
Taken.

>give main key to wooden chair
You can only do that to something animate.

>use main key
I didn't understand that number.

* * *

>take main key
A chill runs up your spine
Taken.

>interact with dog
Ass.

    *** The End ***

Would you like to RESTART, RESTORE a saved game, QUIT or UNDO the last command?

* * *

>take marble toilet
Taken.

* * *

>unlock main door
What do you want to unlock Main door with?

* * *

>main key
(first taking Main key)
A chill runs up your spine
You unlock Main door.

>enter door
(first opening Main door)

Hall
The room is dark and difficult to see without light.

The stairs are... weird?

You can also see Gray door, Main door, Red door and Wooden Table (on which is family photograph) here.

The inside smells as bad news...

>enter stair
You can't see any such thing.

>enter stairs
Otário.

>look
Hall
The room is dark and difficult to see without light.

The stairs are... weird?

You can also see Gray door, Main door, Red door and Wooden Table (on which is family photograph) here.

* * *

>enter door
(first opening Main door)

Hall
The room is dark and difficult to see without light.

The stairs are... weird?

You can also see Gray door, Main door, Red door and Wooden Table (on which is family photograph) here.

The inside smells as bad news...

>open gray door
It seems to be locked.

>open red door
You open Red door.

>enter red door
Living Room
You can see White door, Red door, Brown door and Yellow door here.

Alguém está gritando pedindo ajuda.

* * *

>enter main door
(first opening Main door)

Hall
The room is dark and difficult to see without light.

The stairs are... weird?

You can also see Gray door, Main door, Red door and Wooden Table (on which is family photograph) here.

The inside smells as bad news...

>enter red door
(first opening Red door)

Living Room
This room is oddly empty, like a hurricane has passed by removing all the furniture. Only 4 doors can be seen.

You can see White door, Red door, Brown door and Yellow door here.

>enter yellow door
(first opening Yellow door)

Dining Room
The dining room looks like to be more conserved than the other rooms. The forniture is fancy, but very strange.

You can see Yellow door, Green door, Large Wooden Table (on which is fresh apple), Old Chair and Shelf (on which is strange photograph) here.

You hear something knocking the wall out there.

>enter green door
(first opening Green door)

Kitchen
It seems to be a normal kitchen, but not used for a lonf time. There are rotten food in the cabinet and a few dead rats on the floor. The smell is intolerable. You feel seasick only by staying in this room.

You can see Green door, Orange door, Furnace (on which is old pressure cooker), Simple Table (on which are an Orange key and dirty napkin) and Cabinet (empty) here.

>enter green door
Dining Room
The dining room looks like to be more conserved than the other rooms. The forniture is fancy, but very strange.

You can see Green door, Yellow door, Large Wooden Table (on which is fresh apple), Old Chair and Shelf (on which is strange photograph) here.

You really heard someone shouting in the next room.
You can respond this supplicant or simply ignore it!

>take fresh apple
Suddenly, the apple begins to rot in your hands, the radio turn on and start to play strange sounds. You can hear strange heart beats coming from the eletronic device.

The unidentified noise is still coming from the Garage.

>left
I didn't understand that number.

>go left
You can't see any such thing.

>go north
You can't go that way.

The unidentified noise is still coming from the Garage.

>go south
Living Room
This room is oddly empty, like a hurricane has passed by removing all the furniture. Only 4 doors can be seen.

You can see Yellow door, White door, Red door and Brown door here.

The unidentified noise is still coming from the Garage.

>go north
Dining Room
The dining room looks like to be more conserved than the other rooms. The forniture is fancy, but very strange.

You can see Yellow door, Green door, Large Wooden Table, Old Chair and Shelf (on which is strange photograph) here.

The unidentified noise is still coming from the Garage.

>go west
Kitchen
It seems to be a normal kitchen, but not used for a lonf time. There are rotten food in the cabinet and a few dead rats on the floor. The smell is intolerable. You feel seasick only by staying in this room.

You can see Green door, Orange door, Furnace (on which is old pressure cooker), Simple Table (on which are an Orange key and dirty napkin) and Cabinet (empty) here.

The unidentified noise is still coming from the Garage.

>go south
(first opening Orange door)
It seems to be locked.

The unidentified noise is still coming from the Garage.

>give rotten apple
(to the homeless)
You can't reach into Garage.

The unidentified noise is still coming from the Garage.

>examine rotten apple
You see nothing special about rotten apple.

It has a terrible smell.

The unidentified noise is still coming from the Garage.

>go to garage
You can't see any such thing.

* * *

>enter main door
(first opening Main door)

Hall
The room is dark and difficult to see without light.

The stairs are... weird?

You can also see Gray door, Main door, Red door and Wooden Table (on which is family photograph) here.

The inside smells as bad news...

>enter stairs
Otário.

>examine zeta stone
You can't see any such thing.

>give zeta stone to Stone Statue
You can't see any such thing.

>examine main key
An old and robust key. It seems like it is not used for more than 10 years. Probably opens the Main Door.

>give main key to stone statue
You can only do that to something animate.

>give main key to stone statue
You can only do that to something animate.

* * *

>enter main door
(first opening Main door)

Hall
The room is dark and difficult to see without light.

The stairs are... weird?

You can also see Gray door, Main door, Red door and Wooden Table (on which is family photograph) here.

The inside smells as bad news...

>examine family photograph
You see nothing special about family photograph.

>take
What do you want to take?

>take family photograph
Hey, Vsauce.

>look
Hall
You can see Gray door, Main door, Red door and Wooden Table here.

>enter red door
(first opening Red door)

Living Room
You can see White door, Red door, Brown door and Yellow door here.

Alguém está gritando pedindo ajuda.

>enter brown door
(first opening Brown door)
It seems to be locked.

>enter white door
(first opening White door)
It seems to be locked.

>enter yellow door
(first opening Yellow door)

Dining Room
You can see Yellow door, Green door, Large Wooden Table (on which is fresh apple), Old Chair and Shelf (on which is strange photograph) here.

* * *

>enter main door
(first opening Main door)

Hall
The room is dark and difficult to see without light.

The stairs are... weird?

You can also see Gray door, Main door, Red door and Wooden Table (on which is family photograph) here.

The inside smells as bad news...

>go north
Living Room
Alguém está gritando pedindo ajuda.

* * *

>enter main door
(first opening Main door)

Hall
The room is dark and difficult to see without light.

The stairs are... weird?

You can also see Gray door, Main door, Red door and Wooden Table (on which is family photograph) here.

The inside smells as bad news...

>take family photograph
I should examine it.

>examine family photograph
Giving a closer look on the photo you see two kids, a boy and a girl, with their parents. Behind them, there is a house being constructed.

>open red door
You open Red door.

>enter red door
Living Room
This room is oddly empty, like a hurricane has passed by removing all the furniture. Only 4 doors can be seen.

You can see White door, Red door, Brown door and Yellow door here.

>yellow door
I didn't understand that number.

>open yellow door
You open Yellow door.

You hear something knocking the wall out there.

>hear
What do you want to hear?

>the wall
You can't see any such thing.

>examine brown door
You see nothing special about Brown door.

>enter yellow door
Dining Room
The dining room looks like to be more conserved than the other rooms. The forniture is fancy, but very strange.

You can see Yellow door, Green door, Large Wooden Table (on which is fresh apple), Old Chair and Shelf (on which is strange photograph) here.

You really heard someone shouting in the next room.
You can respond this supplicant or simply ignore it!

>respond the supplicant
Nobody can hear you, stop talking to yourself!

The unidentified noise is still coming from the Garage.

>take fresh apple
Taken.

The unidentified noise is still coming from the Garage.

* * *

>enter main door
(first opening Main door)

Hall
The room is dark and difficult to see without light.

The stairs are... weird?

You can also see Gray door, Main door, Red door and Wooden Table (on which is family photograph) here.

The inside smells as bad news...

>take photograph
Você olha mais de perto. Uma casal de pais com dois filhos, um menino e uma menina. No fundo uma casa em construção.

>enter red door
(first opening Red door)

Living Room
Descrição Living Room.

You can see White door, Red door, Brown door and Yellow door here.

Assim que você entra no cômodo você ouve gritos de socorro vindo da esquerda, da porta marrom. 
Um homem grita por ajuda dizendo que caiu pelo basculhante e não consegue mais sair.

* * *

>enter main door
(first opening Main door)

Hall
The room is dark and difficult to see without light.

The stairs are... weird?

You can also see Gray door, Main door, Red door and Wooden Table (on which is family photograph) here.

The inside smells as bad news...

>take wooden table
That's fixed in place.

* * *

>main key
(first taking Main key)
A chill runs up your spine
You unlock Main door.

>take doot
You can't see any such thing.

>take dog
Taken.

>enter main door
(first opening Main door)

Hall
Descrição Hall.

You can see Gray door, Main door, Red door, Stairs and Wooden Table (on which is family photograph) here.

The inside smells as bad news...